1111111111111
1001001001001
1001001001001
1000000000101
1001001001001
1001001010001
1001001000101
1000000001001
1001001001001
1001001000101
1001001001001
1001001001001
1111111111111
